45 50 50 50 50 50 50 50 50 50 50 50 50 50 50 50 50 47
52 1 1 1 1 1 1 1 1 1 1 1 1 1 1 1 1 51
52 1 1 1 1 1 1 1 1 1 1 1 1 1 1 1 1 51
52 1 1 1 1 1 1 1 1 1 1 1 1 1 1 1 1 51
52 1 1 1 1 1 1 1 1 1 1 1 1 1 1 1 1 51
52 1 1 1 1 1 1 1 1 1 1 1 1 1 1 1 1 51
52 1 1 1 1 1 1 1 1 1 1 1 1 1 1 1 1 51
52 1 1 1 1 1 1 1 1 1 1 1 1 1 1 1 1 51
52 1 1 1 1 1 1 1 1 1 1 1 1 1 1 1 1 51
52 1 1 1 1 1 1 1 1 1 1 1 1 1 1 1 1 51
52 1 1 1 1 1 1 1 1 1 1 1 1 1 1 1 1 51
52 1 1 1 1 1 1 1 1 1 1 1 1 1 1 1 1 51
52 1 1 1 1 1 1 1 1 1 1 1 1 1 1 1 1 51
46 49 49 49 49 49 49 49 49 49 49 49 49 49 49 49 49 48