27 22 22 22 22 22 22 22 22 22 22 22 22 22 22 22 22 29
24 25 25 25 25 25 25 25 25 25 25 25 25 25 25 25 25 23
24 25 25 26 25 25 25 25 25 25 25 25 25 25 25 25 26 23
24 25 25 25 25 26 25 25 26 25 25 25 25 26 25 25 25 23
24 25 25 25 25 25 25 25 25 25 25 25 25 25 25 25 25 23
24 25 25 25 25 25 25 25 25 25 25 25 25 25 25 25 25 23
24 25 25 25 25 25 26 25 25 25 25 25 26 25 25 25 25 23
24 25 26 25 25 25 25 25 25 25 25 25 25 25 25 26 25 23
24 25 25 25 25 25 25 25 25 25 25 25 25 25 25 25 25 23
24 25 25 25 26 25 25 25 25 25 25 26 25 25 25 25 25 23
24 25 25 25 25 25 25 25 25 25 25 25 25 25 25 25 25 23
24 25 26 25 25 25 25 26 25 25 25 25 25 25 25 26 25 23
24 25 25 25 25 25 25 25 25 25 25 25 25 25 25 25 25 23
28 21 21 21 21 21 21 21 21 21 21 21 21 21 21 21 21 30