8 8 8 8 8 8 8 8 8 8 8 8 8 8 8 8 8 8
8 6 6 6 6 6 6 6 6 6 6 10 10 10 10 10 10 8
8 6 6 6 6 6 6 6 6 6 6 10 1 1 1 1 1 5
8 6 6 6 6 6 6 6 6 6 6 10 1 1 1 1 1 5
8 6 6 6 6 6 6 6 6 6 6 10 1 1 10 10 10 8
8 10 10 10 10 10 10 10 10 10 10 10 1 1 10 6 6 8
4 1 1 1 1 1 1 1 1 1 1 1 1 1 10 6 6 8
4 1 1 1 1 1 1 1 1 1 1 1 1 1 10 6 6 8
8 10 10 10 10 10 10 10 10 10 10 10 1 1 10 6 6 8
8 6 6 6 6 6 6 6 6 6 6 10 1 1 10 6 6 8
8 6 6 6 6 6 6 6 6 6 6 10 1 1 10 6 6 8
8 6 6 6 6 6 6 6 6 6 6 10 1 1 10 6 6 8
8 6 6 6 6 6 6 6 6 6 6 10 1 1 10 6 6 8
8 8 8 8 8 8 8 8 8 8 8 8 3 3 8 8 8 8
