33 33 33 33 33 33 33 33 33 33 33 33 33 33 33 33 33 33
33 33 33 33 33 33 32 33 33 32 33 33 33 33 33 33 33 33
4 31 31 31 31 33 32 33 33 32 33 33 33 33 33 33 33 33
4 31 31 31 31 33 32 33 33 32 31 31 31 31 31 33 33 33
33 33 33 33 32 33 31 31 31 32 33 33 33 33 31 31 31 33
33 33 33 33 32 33 33 33 33 32 33 33 33 33 33 33 33 33
33 33 33 33 32 33 33 33 32 31 31 31 31 31 31 31 33 33
33 33 33 33 32 33 33 33 32 33 33 33 32 33 33 32 33 33
33 33 33 33 32 33 33 33 32 33 33 33 31 31 31 31 33 33
33 33 33 33 32 33 33 33 32 33 33 33 33 33 33 32 32 33
33 33 32 31 31 33 33 33 32 33 33 33 33 33 32 32 33 33
33 33 32 33 33 33 33 33 32 33 33 33 33 33 32 32 33 33
33 33 32 31 31 31 31 31 32 33 33 33 33 33 32 32 33 33
33 33 33 33 33 33 33 33 33 33 33 33 33 33 3 3 33 33