17 17 17 17 17 17 17 17 17 17 17 17 17 17 17 17 17 17
17 56 11 11 12 11 13 11 12 11 11 11 13 12 11 11 15 17
17 18 14 15 14 15 14 15 14 15 14 15 14 15 14 15 15 17
17 18 15 15 15 15 15 15 15 15 15 15 15 15 15 15 15 17
17 19 14 15 15 14 14 15 15 15 15 15 14 14 15 15 15 17
17 18 15 15 15 16 16 15 15 15 15 15 16 16 15 15 15 17
17 20 14 15 15 14 14 15 15 15 15 15 14 14 15 15 15 4
17 18 15 15 15 15 15 15 14 16 14 15 15 15 15 15 15 4
17 18 14 15 14 14 15 15 15 15 15 15 15 15 15 15 15 17
17 19 15 15 16 16 15 15 15 15 15 15 15 15 14 15 15 17
17 19 14 15 14 14 15 15 15 14 14 15 15 15 16 15 15 17
17 18 15 15 15 15 15 15 15 16 16 15 15 15 14 15 15 17
17 15 15 15 15 15 15 15 15 14 14 15 15 15 15 15 15 17
17 17 17 17 17 17 17 17 17 17 17 17 17 17 17 17 17 17