8 54 53 53 53 53 53 53 53 53 53 53 53 53 53 53 55 8
8 6 6 6 6 6 6 6 6 6 6 6 6 6 6 6 6 8
8 6 6 6 6 6 6 6 6 6 6 6 6 6 6 6 6 8
8 6 6 6 6 6 6 6 6 6 6 6 6 6 6 6 6 8
8 6 6 6 6 6 6 6 6 6 6 6 6 6 6 6 6 8
8 6 6 6 6 6 6 6 6 6 6 6 6 6 6 6 6 8
8 6 6 6 6 6 6 6 6 6 6 6 6 6 6 6 6 8
8 6 6 6 6 6 6 6 6 6 6 6 6 6 6 6 6 8
8 6 6 6 6 6 6 6 6 6 6 6 6 6 6 6 6 8
8 6 6 6 6 6 6 6 6 6 6 6 6 6 6 6 6 8
8 6 6 6 6 6 6 6 6 6 6 6 6 6 6 6 6 8
8 6 6 6 6 6 6 6 6 6 6 6 6 6 6 6 6 8
8 6 6 6 6 6 6 6 6 6 6 6 6 6 6 6 6 8
8 11 11 12 13 11 13 12 11 11 12 13 13 11 11 12 11 8