8 8 8 8 8 8 8 8 8 8 8 0 0 8 8 8 8 8
8 10 10 6 6 6 6 6 6 6 6 6 6 10 10 10 10 8
8 10 6 2 43 6 6 6 6 6 6 6 6 6 1 1 1 8
8 6 6 43 6 6 6 6 6 6 6 6 6 6 1 1 39 8
8 6 6 6 10 6 6 6 10 6 6 6 6 6 1 1 38 8
8 6 6 6 6 6 6 6 6 6 6 6 6 6 1 1 38 8
8 1 1 1 6 6 6 6 6 6 6 6 6 6 1 1 38 8
8 36 1 1 6 10 6 6 6 6 6 6 6 6 1 1 37 8
8 35 1 1 6 6 6 6 10 6 6 6 6 6 1 1 1 8
8 35 1 1 6 6 6 6 6 6 10 6 6 6 6 6 6 8
8 34 1 1 6 6 6 6 6 10 6 10 6 6 6 6 6 8
8 1 1 1 6 6 6 1 44 44 44 44 1 6 6 6 6 8
8 10 10 6 6 6 6 1 42 41 41 40 1 6 6 6 10 8
8 8 8 8 8 8 8 8 8 8 8 8 8 8 8 8 8 8
